,Species,Genus,Family,Higher,Total
Antarctica,137,8,1,16,162
Punta Arenas,112,20,0,0,132
Puerto Madryn,333,182,0,37,552
Concepcion,417,53,7,25,502
Montemar,163,6,0,4,173
Arraial do Cabo,1050,68,18,15,1151
Costa Das Algas,386,68,24,0,478
Santa Cruz,46,33,1,0,80
Fernando de Noronha,125,75,8,9,217
Isla Gorgona,231,136,7,0,374
Massachusetts,97,31,0,0,128
Biddeford,57,6,0,0,63
Giant Stairs,68,12,0,0,80
Chamberlain,73,3,0,0,76
Grindstone,34,19,0,0,53
N. Maine,112,35,0,0,147
